                
 2            2   
111          111
111          111
111          111
111          111
111          111
111          111
111          111
111    3     111
1111111111111111
4111111111111111
