111111111111111111111111111111111111111
1                  1                  1
1                3 1                  1
1                  1                  1
122222222      11111       1111111    1
1                                     1
1                          5          1
1                                     1
1                 22111111111111      1
1     2222222    22222                1
1                 222                 1
1                 222                 1
1                 222                 1
1                 212                 1
1      22222222222212                 1
1                 212                 1
1       5          212          5     1
1                 212                 1
1              222212                 1
11111111       222222                 1
1              225 22                 1
1              22  22                 1
1              222222        1111111111
1              212222                 1
1              21                     1
1       5      222222222222222        1
1              21                     1
1              22                     1
1              22                     1
1              222222222222222222     1
1              22                     1
1   1111111111112                     1
1                                     1
1                                     1
1                                     1
1       5     111111                  1
1             1                       1
1             1  4                    1
1             1                       1
111111111111111111111111111111111111111